11111111111111111
10000000100000001
10000000111010001
10000010000100011
10000000000000001
10P0000E000000001
100000C0000000001
11111111111111111
