11111111111111111
1000000P0E0000001
10000000000010001
10000010000100011
10000000000000001
10000000000000001
1000E0C0000000001
11111111111111111
