11111111111111111
100000000E0000001
10000000000010001
10000010000100011
100P00000C0000001
10000000000000001
1000C000000000001
11111111111111111